01,01,01,01,01,01,01,01,01,01,01,01,01,01,01,01,01,01,01,01,01,01,01,01,01
01,15,15,15,15,14,13,14,03,03,03,03,03,03,03,01,03,03,03,03,03,03,03,03,01
01,15,14,15,15,19,19,19,03,03,03,06,08,03,22,01,03,21,21,21,03,14,14,03,01
01,15,15,15,15,09,09,09,02,02,02,05,07,02,02,01,02,02,02,02,02,02,02,02,01
01,11,00,00,00,00,00,00,00,00,00,00,00,00,00,01,18,18,18,18,18,18,18,12,01
01,00,00,00,00,00,00,00,00,00,00,00,00,00,00,01,18,18,18,18,18,18,18,18,01
01,00,00,00,00,00,00,00,00,00,00,00,00,00,00,18,18,18,17,16,18,17,16,18,01
01,00,00,00,00,00,00,00,00,00,00,00,00,00,00,18,18,18,18,18,18,18,18,18,01
01,01,01,01,01,01,01,01,01,01,00,00,00,00,00,01,01,01,01,01,01,01,01,01,01
01,03,13,03,03,03,03,03,03,03,00,00,00,00,00,03,03,03,03,03,03,03,03,03,01
01,03,14,21,21,19,19,03,22,03,00,00,00,00,00,22,03,03,21,21,03,19,19,19,01
01,02,02,02,02,09,09,02,02,02,00,00,00,00,00,02,02,02,02,02,02,09,09,09,01
01,04,04,04,04,04,04,04,04,04,00,00,00,00,00,04,04,04,04,04,04,04,04,04,01
01,04,04,04,04,04,04,04,04,04,00,00,00,00,00,04,04,17,16,04,04,17,16,04,01
01,04,17,16,04,17,16,04,04,01,00,00,00,00,00,01,04,04,04,04,04,04,04,04,01
01,04,04,04,04,04,04,04,04,01,00,00,00,00,00,01,04,17,16,04,04,17,16,04,01
01,04,04,04,04,04,04,04,04,01,00,00,00,00,00,01,04,04,04,04,04,04,04,04,01
01,04,17,16,04,17,16,04,04,01,00,00,00,00,00,01,04,04,04,04,04,04,04,04,01
01,04,04,04,04,04,04,04,12,01,11,00,00,00,11,01,04,04,04,17,16,04,04,12,01
01,01,01,01,01,01,01,01,01,01,01,01,01,01,01,01,01,01,01,01,01,01,01,01,01

1,1,1,1,1,1,1,1,1,1,1,1,1,1,1,1,1,1,1,1,1,1,1,1,1
1,1,1,1,1,1,1,1,1,1,1,1,1,1,1,1,1,1,1,1,1,1,1,1,1
1,1,1,1,1,1,1,1,1,1,1,1,1,1,1,1,1,1,1,1,1,1,1,1,1
1,1,0,0,0,0,0,0,0,0,0,0,0,0,0,1,0,0,0,0,0,0,0,1,1
1,1,0,0,0,0,0,0,0,0,0,0,0,0,0,1,0,0,0,0,0,0,0,1,1
1,0,0,0,0,0,0,0,0,0,0,0,0,0,0,1,0,0,0,0,0,0,0,0,1
1,0,0,0,0,0,0,0,0,0,0,0,0,0,0,0,0,0,1,1,0,1,1,0,1
1,0,0,0,0,0,0,0,0,0,0,0,0,0,0,0,0,0,0,0,0,0,0,0,1
1,1,1,1,1,1,1,1,1,1,0,0,0,0,0,1,1,1,1,1,1,1,1,1,1
1,1,1,1,1,1,1,1,1,1,0,0,0,0,0,1,1,1,1,1,1,1,1,1,1
1,1,1,1,1,1,1,1,1,1,0,0,0,0,0,1,1,1,1,1,1,1,1,1,1
1,0,0,0,0,0,0,0,0,0,0,0,0,0,0,0,0,0,0,0,0,0,0,0,1
1,0,0,0,0,0,0,0,0,0,0,0,0,0,0,0,0,0,0,0,0,0,0,0,1
1,0,0,0,0,0,0,0,0,0,0,0,0,0,0,0,0,1,1,0,0,1,1,0,1
1,0,1,1,0,1,1,0,0,1,0,0,0,0,0,1,0,0,0,0,0,0,0,0,1
1,0,0,0,0,0,0,0,0,1,0,0,0,0,0,1,0,1,1,0,0,1,1,0,1
1,0,0,0,0,0,0,0,0,1,0,0,0,0,0,1,0,0,0,0,0,0,0,0,1
1,0,1,1,0,1,1,0,0,1,0,0,0,0,0,1,0,0,0,0,0,0,0,0,1
1,0,0,0,0,0,0,0,0,1,1,0,0,0,1,1,0,0,0,1,1,0,0,1,1
1,1,1,1,1,1,1,1,1,1,1,1,1,1,1,1,1,1,1,1,1,1,1,1,1